28 28 28 28 28 28 28 28 28 28 28 28 28 28 28 28 28 28 28 28 28 28 28 28 28 28 28 28 28 28 28 28 28 28 28 28 28 28 28 28 28 28 28 28 28 28 28 28 28 28
28 28 28 28 28 28 28 28 28 28 28 28 28 28 28 28 28 28 28 28 28 28 28 28 28 28 28 28 28 28 28 28 28 28 28 28 28 28 28 28 28 28 28 28 28 28 28 28 28 28
28 28 28 28 28 28 28 28 28 28 28 28 28 28 28 28 28 28 28 28 28 28 28 28 28 28 28 28 28 28 28 28 28 28 28 28 28 28 28 28 28 28 28 28 28 28 28 28 28 28
28 28 28 28 28 28 28 28 28 28 28 28 28 28 28 28 28 28 28 28 28 28 28 28 28 28 28 28 28 28 28 28 28 28 28 28 28 28 28 28 28 28 28 28 28 28 28 28 28 28
28 28 28 28 28 28 28 28 28 28 28 28 28 28 28 28 28 28 28 28 28 28 28 28 28 28 28 28 28 28 28 28 28 28 28 28 28 28 28 28 28 28 28 28 28 28 28 28 28 28
28 28 28 28 28 28 38 36 36 36 36 36 36 36 36 36 36 36 36 36 36 36 36 36 36 36 36 36 36 36 36 36 36 36 36 36 36 36 36 36 39 28 28 28 28 28 28 28 28 28
28 28 28 28 28 28 34 11 11 11 11 11 11 11 11 11 11 11 11 11 11 11 11 11 11 11 11 11 11 11 11 11 11 11 11 11 11 11 11 11 33 28 28 28 28 28 28 28 28 28
28 28 28 28 28 28 34 12 11 11 11 12 11 11 11 11 11 11 11 11 11 11 12 11 11 11 11 11 11 11 11 11 11 11 11 11 11 11 11 11 33 28 28 28 28 28 28 28 28 28
28 28 28 28 28 28 34 11 11 11 11 11 11 11 11 12 11 11 11 11 11 11 11 12 11 11 11 11 11 11 11 11 11 11 11 11 11 11 11 11 33 28 28 28 28 28 28 28 28 28
28 28 28 28 28 28 34 11 11 11 12 11 11 11 11 11 11 11 11 12 11 11 11 11 11 11 11 11 11 11 11 11 11 11 11 11 11 11 11 11 33 28 28 28 28 28 28 28 28 28
28 28 28 28 28 28 34 11 11 11 11 11 11 11 11 11 12 11 11 11 11 11 12 11 11 11 11 11 11 11 11 11 11 11 11 11 11 11 11 11 33 28 28 28 28 28 28 28 28 28
28 28 28 28 28 28 34 12 11 11 11 42 42 42 42 42 11 11 11 11 11 11 11 11 11 11 11 11 11 11 11 11 11 11 11 11 11 11 11 11 33 28 28 28 28 28 28 28 28 28
28 28 28 28 28 28 34 26 11 11 11 49 44 44 44 48 11 11 11 11 12 11 11 11 11 11 11 11 11 11 11 11 11 11 11 11 11 11 11 11 33 28 28 28 28 28 28 28 28 28
28 28 28 28 28 28 34 26 11 11 11 49 44 44 44 48 11 26 26 26 11 11 11 11 11 11 11 11 11 11 11 11 11 11 11 11 11 11 11 11 33 28 28 28 28 28 28 28 28 28
28 28 28 28 28 28 34 26 26 11 11 49 44 44 44 48 11 26 26 26 11 11 11 11 11 11 11 11 11 11 11 11 11 11 11 11 11 11 11 11 33 28 28 28 28 28 28 28 28 28
28 28 28 28 28 28 34 26 26 11 11 49 44 44 44 48 11 11 26 11 11 12 11 11 11 11 11 11 11 11 11 11 11 11 11 11 11 11 11 11 33 28 28 28 28 28 28 28 28 28
28 28 28 28 28 28 34 11 26 11 11 42 42 44 42 42 11 12 11 11 11 11 11 11 11 11 11 11 11 11 11 11 11 11 11 11 11 11 11 11 33 28 28 28 28 28 28 28 28 28
28 28 28 28 28 28 34 11 26 11 11 11 18 13 17 11 11 11 11 12 11 11 11 11 11 11 11 11 11 11 11 11 11 11 11 11 11 11 11 11 33 28 28 28 28 28 28 28 28 28
28 28 28 28 28 28 34 26 11 11 12 11 18 13 17 11 11 11 11 11 11 11 11 11 11 11 11 11 11 11 11 11 11 11 11 11 11 11 11 11 33 28 28 28 28 28 28 28 28 28
28 28 28 28 28 28 34 11 26 11 11 26 18 13 17 12 11 11 26 11 11 11 11 11 11 11 11 11 11 11 11 11 11 11 11 11 11 11 11 11 33 28 28 28 28 28 28 28 28 28
28 28 28 28 28 28 34 11 11 11 11 11 18 13 17 11 12 11 11 11 11 11 11 11 11 11 11 11 11 11 11 11 11 11 11 11 11 11 11 11 33 28 28 28 28 28 28 28 28 28
28 28 28 28 28 28 34 11 11 11 11 11 18 13 17 12 11 11 11 11 11 11 11 11 11 11 11 11 11 11 11 11 11 11 11 11 11 11 11 11 33 28 28 28 28 28 28 28 28 28
28 28 28 28 28 28 34 11 11 11 11 11 18 13 19 20 20 20 20 20 11 11 11 11 11 11 11 30 31 31 31 32 11 11 11 11 11 11 11 11 33 28 28 28 28 28 28 28 28 28
28 28 28 28 28 28 34 11 11 11 11 11 18 13 13 13 13 13 13 13 11 11 11 11 11 11 11 33 28 28 28 34 11 11 11 11 11 11 11 11 33 28 28 28 28 28 28 28 28 28
28 28 28 28 28 28 34 11 11 11 11 11 24 15 15 15 15 15 15 15 11 11 11 11 11 11 11 33 28 28 28 34 11 11 11 11 11 11 11 11 33 28 28 28 28 28 28 28 28 28
28 28 28 28 28 28 34 11 12 11 11 11 12 26 11 11 11 11 11 26 11 11 11 11 11 11 11 33 28 28 28 34 11 11 11 11 11 11 11 11 33 28 28 28 28 28 28 28 28 28
28 28 28 28 28 28 34 11 11 11 11 11 26 26 26 11 11 11 26 26 11 11 11 11 11 11 11 33 28 28 28 34 11 11 11 11 11 11 11 11 33 28 28 28 28 28 28 28 28 28
28 28 28 28 28 28 34 12 11 11 11 26 26 26 11 11 11 11 26 11 11 11 11 11 11 11 11 35 36 36 36 37 11 11 11 11 11 11 11 11 33 28 28 28 28 28 28 28 28 28
28 28 28 28 28 28 34 11 11 11 11 26 26 11 11 11 11 11 11 11 11 11 11 11 11 11 11 11 11 11 11 11 11 11 11 11 11 11 11 11 33 28 28 28 28 28 28 28 28 28
28 28 28 28 28 28 34 11 11 12 11 12 26 11 11 11 11 11 11 11 11 11 11 11 11 11 11 11 11 11 11 11 11 11 11 11 11 11 11 11 33 28 28 28 28 28 28 28 28 28
28 28 28 28 28 28 34 11 11 11 11 11 11 11 11 11 11 11 11 11 11 11 11 11 11 11 11 11 11 11 11 11 11 11 11 11 11 11 11 11 33 28 28 28 28 28 28 28 28 28
28 28 28 28 28 28 34 11 11 11 11 11 12 11 11 11 11 11 11 11 11 11 11 11 11 11 11 11 11 11 11 11 11 11 11 11 11 11 11 11 33 28 28 28 28 28 28 28 28 28
28 28 28 28 28 28 34 11 11 11 11 11 11 11 11 11 11 11 11 11 11 11 11 11 11 11 11 11 11 11 11 11 11 11 11 11 11 11 11 11 33 28 28 28 28 28 28 28 28 28
28 28 28 28 28 28 34 11 11 11 11 12 11 11 11 11 11 11 11 11 11 11 11 11 11 11 11 11 11 11 11 11 11 11 11 11 11 11 11 11 33 28 28 28 28 28 28 28 28 28
28 28 28 28 28 28 34 11 11 11 11 11 11 11 11 11 11 11 11 11 11 11 11 11 11 11 11 11 11 11 11 11 11 11 11 11 11 11 11 11 33 28 28 28 28 28 28 28 28 28
28 28 28 28 28 28 34 11 11 12 11 11 11 11 11 11 11 11 11 11 11 11 11 11 11 11 11 11 11 11 11 11 11 11 11 11 11 11 11 11 33 28 28 28 28 28 28 28 28 28
28 28 28 28 28 28 34 12 11 11 11 11 11 11 11 11 11 11 11 11 11 11 11 11 11 11 11 11 11 11 11 11 11 11 11 11 11 11 11 11 33 28 28 28 28 28 28 28 28 28
28 28 28 28 28 28 34 11 11 11 11 11 11 11 11 11 11 11 11 11 11 11 11 11 11 11 11 11 11 11 11 11 11 11 11 11 11 11 11 11 33 28 28 28 28 28 28 28 28 28
28 28 28 28 28 28 34 11 12 11 11 12 11 12 11 11 11 11 11 11 11 11 11 11 11 11 11 11 11 11 11 11 11 11 11 11 11 11 11 11 33 28 28 28 28 28 28 28 28 28
28 28 28 28 28 28 34 11 11 11 11 11 11 11 11 11 11 11 11 11 11 11 11 11 11 11 11 11 11 11 11 11 11 11 11 11 11 11 11 11 33 28 28 28 28 28 28 28 28 28
28 28 28 28 28 28 34 11 11 11 12 11 12 11 11 11 11 11 11 11 11 11 11 11 11 11 11 11 11 11 11 11 11 11 11 11 11 11 11 11 33 28 28 28 28 28 28 28 28 28
28 28 28 28 28 28 40 31 31 31 31 31 31 31 31 31 31 31 31 31 31 31 31 31 31 31 31 31 31 31 31 31 31 31 31 31 31 31 31 31 41 28 28 28 28 28 28 28 28 28
28 28 28 28 28 28 28 28 28 28 28 28 28 28 28 28 28 28 28 28 28 28 28 28 28 28 28 28 28 28 28 28 28 28 28 28 28 28 28 28 28 28 28 28 28 28 28 28 28 28
28 28 28 28 28 28 28 28 28 28 28 28 28 28 28 28 28 28 28 28 28 28 28 28 28 28 28 28 28 28 28 28 28 28 28 28 28 28 28 28 28 28 28 28 28 28 28 28 28 28
28 28 28 28 28 28 28 28 28 28 28 28 28 28 28 28 28 28 28 28 28 28 28 28 28 28 28 28 28 28 28 28 28 28 28 28 28 28 28 28 28 28 28 28 28 28 28 28 28 28
28 28 28 28 28 28 28 28 28 28 28 28 28 28 28 28 28 28 28 28 28 28 28 28 28 28 28 28 28 28 28 28 28 28 28 28 28 28 28 28 28 28 28 28 28 28 28 28 28 28
28 28 28 28 28 28 28 28 28 28 28 28 28 28 28 28 28 28 28 28 28 28 28 28 28 28 28 28 28 28 28 28 28 28 28 28 28 28 28 28 28 28 28 28 28 28 28 28 28 28
28 28 28 28 28 28 28 28 28 28 28 28 28 28 28 28 28 28 28 28 28 28 28 28 28 28 28 28 28 28 28 28 28 28 28 28 28 28 28 28 28 28 28 28 28 28 28 28 28 28
28 28 28 28 28 28 28 28 28 28 28 28 28 28 28 28 28 28 28 28 28 28 28 28 28 28 28 28 28 28 28 28 28 28 28 28 28 28 28 28 28 28 28 28 28 28 28 28 28 28
28 28 28 28 28 28 28 28 28 28 28 28 28 28 28 28 28 28 28 28 28 28 28 28 28 28 28 28 28 28 28 28 28 28 28 28 28 28 28 28 28 28 28 28 28 28 28 28 28 28